1000000000000000000000000000000000000000000000000000000000000000000000000000000000000000000000000000000000000000000000000000000000000000000001
1000000000000000000000000000000000000000000000000000000000000000000000000000000000000000000000000000000000000000000000000000000000000000000001
1001110010010010011110000000000000000000000000000000000000000000000000000000000000000000000000000000000000000000000000000000000000000000000001
11000000000000000010000000000000000000000d00d00d00d00d00d00d00d00d00d00d00d00000000000000000000000DDDDDDDDDDDDDDDDDDDDDDDDDDDDD000000000000001
110d000000000000001000000000000000011111111111111111111111111111111111111111110010010010011111111111111111111111111111111111111111111111110001
1111111000000000001000000000000000000000000000000000000000000000000000000000110000000000011000000000000000000000000000000000000000000000000001
1000000110000000001000000000000000100000000000000000000000000000000000000000110000000000011000000000000000000000000000000000000000000000000001
100000000011000000100000000000000000000000000000000000000000ddddddddddddd000110000000000011000000000000000000000000000000000000000000000000011
10000000000001100010000000d00000010000000000000111111111111111111111111111111100000000000110000D0D0D0D0011001100110011001100111111111100000011
1000000000000000011001100111001000000000001111100000000000000000000000000000000000000000011001111111111100000000000000000000000000000000111111
1000000000000011000000000000000000000000110000000000000000000000000000000000000000000000011001100000000000000000000000000000000000000001111111
1000000000011000000000000000000000000011000000000000000000ddddddddddddd0000000000000000001100110000000DDDDDDDDDDDDDDDDDDDDDDDDD000000001111111
1000000011000000000000000000000001110000000000000000011111111111111111111100110000000000011001111111111111111111111111111111111111111111111111
10000000000ddddddddd00000000000001110000000000000010000000000000000000000001110000000000011000000000000000000000000000000000000000000000011111
1000111111111111111111111111111111111111111110000010000000000000000000000001110000000000011000000000000000000000000000000000000000000000001111
110000000000000000000000000000000000000000001100111000000000000000000000001111000000000001100000DDDDDDDDDDDDDDDDDDDDDDDDDDDDDDD000000000000111
11000000000000000000000000000000000000000000110001100ddddddddddddddd00000011110000000000011111111111111111111111111111111111111110000000000111
111000ddddd00000000000d00000000000000000000001100111111111111111111111000111110000000000011000000000000000000000000000000000000000000000000011
1111111111111111111111100000000000000000000000000110000000000000000000000111110000000000011000000000000000000000000000000000000000000000000011
1000000000000000000000000000000000000000000000001110000000000000000000001111110000000000011000000000000000000000000000000000000000000000000004
1000000000000000000000001001011010010000000000001110000000000000000000001111110000000000011000000000000000000000000000000000000000000000000004
1P0000000000000000000001100000000001100ddd00001111100ddddddddddddddd00011111110000000000011111111111111111111111111111111111111111111111111111
1111111111111111111111111000000000011111111111111111111111111111111111111111110000000000011111111111111111111111111111111111111111111111111111
1111111111111111111111111333333333311111111111111111111111111111111111111111113333333333311111111111111111111111111111111111111111111111111111