100000000000000000000000000000000000000001
100000000000000000000000000000000000000001
100000000000000000000000000000000000000001
100000000000000000000000000000000000000001
100000000000000000000000000000000000000001
100000000000000000000000000000000000000001
100000000000000000000000010000000000000001
100000000000000000000000010000000000000001
100000000000000000000000010000000000000001
100000000000000000000000010000000000000001
100000000000000000000000010000000000000001
100000000000000000000000010000000000000001
100000000000000000000000010000000000000001
100000000000000000000000010000000000000001
100000000000011001100111110000000000000001
100000000000000000010010000100000000000001
111111000110000000000010000100000000000001
100010000000000000000011111100000000000001
100010000001000000011110000100000000000001
100011110011000111100000000111100000000001
100000000111110000000000000000111111111111
1P00d0001111110000000000000000111111111111
111111111111111111111111111111111111111111